alias assignments on rzansel
Thu Feb 14 14:17:52 PST 2019

alias again='cd ../; rm -rf build; mkdir build;  cd build'
alias bcat='cat    /g/g13/topa1/.bashrc'
alias cc2='ssh -l dantopa -XY ccscs2'
alias cc3='ssh -l dantopa -XY ccscs3'
alias cc4='ssh -l dantopa -XY ccscs4'
alias cc5='ssh -l dantopa -XY ccscs5'
alias cc6='ssh -l dantopa -XY ccscs6'
alias cc7='ssh -l dantopa -XY ccscs7'
alias cc8='ssh -l dantopa -XY ccscs8'
alias cctc='ssh -l dantopa -XY ccs-tc'
alias clear_tmp_files='find . -name '\''*~'\'' -exec rm {} \;'
alias contents_alias='echo "write list of alias commands to \${my_log} = ${my_log}"'
alias contents_cmake='echo "ALIAS again, quick, quicker, crun: EXPORT my_log"'
alias contents_disk='echo "ALIAS disk_list, disk_total"'
alias contents_environment='echo "write list of environment commands to environment_variables.txt"'
alias contents_gcc='echo "ALIAS show_gcc show_gcc_versions show_gcc_warnings show_select"; echo "FUNCTION selector"'
alias contents_ssh='echo "ALIAS public_key"'
alias contents_vim='echo "ALIAS v, vc, vm, vM, vcm"'
alias cpu_out='grep -i '\''model name'\'' /proc/cpuinfo | sort | uniq'
alias crun='cd $DEMO_HOME; cd build; cmake ..; make'
alias darwin='ssh -l dantopa -XY darwin-fe.lanl.gov'
alias disk_list='echo "listing of disk usage for $(pwd)"; du -csh * | sort -n'
alias disk_total='echo "total disk usage for $(pwd):";    du -shm'
alias ebf='echo '\''${bash_file}:'\'';  echo '\''.bashrc'\'''
alias echocf='echo $cflags'
alias echogf='echo $gflags'
alias egrep='egrep --color=auto'
alias emp='echo '\''${MODULEPATH}:'\''; echo '\''/usr/tce/modulefiles/MPI/xl/2019.02.07/spectrum-mpi/rolling-release:/usr/tce/modulefiles/Compiler/xl/2019.02.07:/usr/tcetmp/modulefiles/Core:/usr/apps/modulefiles:/usr/share/modulefiles/Linux:/usr/share/modulefiles/Core:/usr/share/lmod/lmod/modulefiles/Core'\'''
alias ep='echo '\''${PATH}:'\'';       echo '\''/usr/tce/packages/cuda/cuda-9.2.148/bin:/usr/tce/packages/spectrum-mpi/spectrum-mpi-rolling-release-xl-2019.02.07/bin:/usr/tce/packages/xl/xl-2019.02.07/bin:/usr/tcetmp/bin:/usr/lib64/qt-3.3/bin:/opt/ibm/spectrumcomputing/lsf/10.1/linux3.10-glibc2.17-ppc64le-csm/etc:/opt/ibm/spectrumcomputing/lsf/10.1/linux3.10-glibc2.17-ppc64le-csm/bin:/usr/local/bin:/usr/bin:/usr/local/sbin:/usr/sbin:/opt/ibm/spectrum_mpi/jsm_pmix/bin:/opt/ibm/bb/bin:/opt/ibm/flightlog/bin:/opt/ibutils/bin:.'\'''
alias epa='echo '\''${partition}:'\'';  echo '\''power9'\'''
alias esp='echo '\''${SPACK_ROOT}:'\''; echo '\'''\'''
alias fgrep='fgrep --color=auto'
alias finder='echo '\''find . -name liblocaepetra.so'\'';  find . -name '\''liblocaepetra.so'\'''
alias ga='ssh -l dantopa -XY ga-fey'
alias gobash='cd /usr/workspace/wsrzc/topa1/repos/Github/LLNL-bash; pwd'
alias gobf='cd /usr/workspace/wsrzc/topa1/repos/Github/node-queries/control/batch-files;   pwd'
alias gobitbucket='cd /usr/workspace/wsrzc/topa1/repos/Bitbucket; pwd'
alias gobo='cd /usr/workspace/wsrzc/topa1/repos/Github/node-queries/control/batch-output;  pwd'
alias gobs='cd /usr/workspace/wsrzc/topa1/repos/Github/node-queries/control/batch-scripts; pwd'
alias gocontrol='cd /usr/workspace/wsrzc/topa1/repos/Github/node-queries/control;       pwd'
alias gocore='cd /usr/workspace/wsrzc/topa1/repos/Github/LLNL-bash/core-scripts;                pwd'
alias godotspack='cd ~/.spack;               pwd'
alias goego='cd /usr/workspace/wsrzc/topa1/repos/Github/node-queries/rzansel;                 pwd'
alias gogithub='cd /usr/workspace/wsrzc/topa1/repos/Github; pwd'
alias gohome='cd /g/g13/topa1;                pwd'
alias gohypre='cd /usr/workspace/wsrzc/topa1/spack-home/spack.rzansel.hypre;  pwd'
alias goid='cd /usr/workspace/wsrzc/topa1/repos/Github/node-queries/rzansel/power9-rzansel61;                  pwd'
alias golap='cd /usr/workspace/wsrzc/topa1/repos/Bitbucket/LLNL-lap; pwd'
alias gomanta='echo '\''ssh -l topa1 -X rzmanta: <password><pin>'\'';          ssh -l topa1 -X rzmanta'
alias gomirror='cd /p/gpfs1/topa1/spack/spack.mirror; pwd'
alias gonode='cd /usr/workspace/wsrzc/topa1/repos/Github/node-queries; pwd'
alias goperformance='cd /usr/workspace/wsrzc/topa1/repos/Bitbucket/Performance_Benchmarking; pwd'
alias goray='echo '\''ssh ray: <password><pin>'\''; ssh ray'
alias gorepos='cd /usr/workspace/wsrzc/topa1/repos;               pwd'
alias gosbatch='gospack; cd sbatch-output; pwd'
alias goscratch='cd /p/gscratchrzm/topa1;             pwd'
alias goseelap='cd /usr/workspace/wsrzc/topa1/repos/Bitbucket/LLNL-lap/rzansel/power9; pwd'
alias gospack='cd /usr/workspace/wsrzc/topa1/spack-home; pwd'
alias gospackp='echo '\''. share/spack/setup-env.sh'\'';. share/spack/setup-env.sh; echo '\''l-spack'\''; l-spack'
alias gosweep='cd /usr/workspace/wsrzc/topa1/repos/Github/node-queries/control/sweep;         pwd'
alias gotopa='cd /usr/workspace/wsrzc/topa1/repos/Bitbucket/Performance_Benchmarking/topa/spack/bash; pwd'
alias govault='cd /usr/workspace/wsrzc/topa1/repos/Github/node-queries/rzansel/power9-rzansel61/dir-configuration;               pwd'
alias gowsdb='cd /usr/workspace/wsrzc/topa1/repos/Bitbucket/Performance_Benchmarking/topa/wsdb; pwd'
alias gozoltan='cd /usr/workspace/wsrzc/topa1/spack-home/spack.rzansel.zoltan; pwd'
alias gpg_check='git verify-commit HEAD~0; export GPG_SIGNED=$?; echo "verify-commit exit code = \$GPG_SIGNED = $GPG_SIGNED"'
alias grab-compute='echo '\''lalloc 2'\''; lalloc 2'
alias grep='grep --color=auto'
alias ihpc='echo '\''ssh -l dantopa -XY    ihpc-gate.lanl.gov <crypto card>'\'';  ssh -l dantopa -XY    ihpc-gate.lanl.gov'
alias k='kinit -f dantopa@lanl.gov'
alias l-spack='. /usr/workspace/wsrzc/topa1/repos/Github/LLNL-bash/core-scripts/spack-init.sh'
alias l.='ls -d .* --color=auto'
alias ll='ls -l --color=auto'
alias ls='ls --color=auto'
alias lss='ls -alh'
alias ma='module available'
alias mc='. /usr/libexec/mc/mc-wrapper.sh'
alias ml='module list'
alias moonlighty='ssh -l dantopa -XY ml-fey'
alias moonlighty1='ssh -l dantopa -XY ml-fey1'
alias moonlighty2='ssh -l dantopa -XY ml-fey2'
alias mothership='git remote show origin'
alias myprompt='export PS1='\''\[\033[00;35m\]\u\[\033[00m\]@\[\033[00;35m\]\H\[\033[00m\]:\[\033[00;33m\]\W\[\033[00m\] $\033[00;36m '\'''
alias oslic='echo '\''ssh -l topa1 -X oslic.llnl.gov'\''; ssh -l topa1 -X oslic.llnl.gov'
alias overwrite='git reset --hard HEAD'
alias pi='ssh -l dantopa -XY pi-fey'
alias pintoy='ssh -l dantopa -XY pi-fey'
alias public_key='cat ~/.ssh/id_rsa.pub'
alias quick='rm -rf build/ && mkdir build && cd build && cmake ..'
alias quicker='cd ..; quick;  make'
alias resetSSH='echo "ssh-keygen -f ~/.ssh/id_rsa -p"; ssh-keygen -f ~/.ssh/id_rsa -p'
alias rslic='echo '\''ssh -l topa1 -X rzslic.llnl.gov'\''; ssh -l topa1 -X rslic.llnl.gov'
alias rzgw='echo '\''ssh -l topa1 -X rzgw.llnl.gov <password><pin>'\'';     ssh -l topa1 -X rzgw.llnl.gov'
alias set_git_proxies='git config --global http.proxy http://proxyout.lanl.gov:8080; git config --global https.proxy http://proxyout.lanl.gov:8080'
alias show_gcc='echo "port select --list gcc"; port select --list gcc'
alias show_gcc_versions='echo "sudo port select --set gcc mp-gccX; port select --list gcc"'
alias show_gcc_warnings_all='gcc -Q --help=warning'
alias show_gcc_warnings_subset='gcc -Wall -Wextra -Q --help=warning'
alias show_names='echo '\''${host_name} = rzansel'\''; echo '\''${partition} = power9'\''; echo '\''${node_name} = rzansel61'\''; echo '\''${prefix}    = rzansel-power9-rzansel61'\''; echo '\''${ego}       = /usr/workspace/wsrzc/topa1/repos/Github/node-queries/rzansel'\''; echo '\''${id}        = /usr/workspace/wsrzc/topa1/repos/Github/node-queries/rzansel/power9-rzansel61'\''; echo '\''${vault}     = /usr/workspace/wsrzc/topa1/repos/Github/node-queries/rzansel/power9-rzansel61/dir-configuration'\'''
alias show_select_gcc='echo "sudo port select --set gcc mp-gccX"; sudo port select --set gcc ${1}'
alias show_select_generic='sudo port select --set ${1} ${2}'
alias sn='ssh -l dantopa -XY sn-fey'
alias snowy='ssh -l dantopa -XY sn-fey'
alias snowy1='ssh -l dantopa -XY sn-fey1'
alias snowy2='ssh -l dantopa -XY sn-fey2'
alias sr='source /g/g13/topa1/.bashrc'
alias sweep_repos='echo '\''. ${core}/git-puller.sh'\''; . /usr/workspace/wsrzc/topa1/repos/Github/LLNL-bash/core-scripts/git-puller.sh'
alias trinititey='ssh -l dantopa -XY tt-fey.lanl.gov'
alias v='echo '\''vi /g/g13/topa1/.bashrc'\''; vi /g/g13/topa1/.bashrc'
alias vM='echo '\''vi Makefile'\'';             vi Makefile'
alias vc='echo '\''vi /usr/workspace/wsrzc/topa1/repos/Github/LLNL-bash/core-scripts/master.sh'\'';    vi /usr/workspace/wsrzc/topa1/repos/Github/LLNL-bash/core-scripts/master.sh'
alias vcm='echo '\''vi CMakeLists.txt'\'';       vi CMakeLists.txt'
alias ve='echo '\''vi '\''; vi /g/g13/topa1/'
alias vi='vim'
alias vm='echo '\''vi makefile'\'';             vi makefile'
alias wf='ssh -l dantopa -XY wf=fey'
alias which='alias | /usr/bin/which --tty-only --read-alias --show-dot --show-tilde'
alias wolfy='ssh -l dantopa -XY wf-fey'
alias wolfy1='ssh -l dantopa -XY wf-fey1'
alias wolfy2='ssh -l dantopa -XY wf-fey2'
alias zerodel='find . -size 0 -delete'
